Enter text here.	Введите текст здесь.
This file must be tab-delimited.	Оригинал и перевод в этом файле должны быть разделены табуляцией.
file	файл
this	этот
miserable	несчастный
get	получить
dog	собака
cat	кошка
cobra	кобра
met	встретила
banana	банан
bat	летучая мышь
cute	милая
next	следующий
strong	сильный
dog and cat	собака и кошка
weak and strong	слабый и сильный
best	лучший
book	книга
shelter	приют
dogs	собаки
cats	кошки
and	и
have fun	весело проводят время
weekend	выходные